"","id","class","math","english","science","tot"
"1",1,1,50,98,50,198
"2",2,1,60,97,60,217
"3",3,1,45,86,78,209
"4",4,1,30,98,58,186
"5",5,2,25,80,65,170
"6",6,2,50,89,98,237
"7",7,2,80,90,45,215
"8",8,2,90,78,25,193
"9",9,3,20,98,15,133
"10",10,3,50,98,45,193
"11",11,3,65,65,65,195
"12",12,3,45,85,32,162
"13",13,4,46,98,65,209
"14",14,4,48,87,12,147
"15",15,4,75,56,78,209
"16",16,4,58,98,65,221
"17",17,5,65,68,98,231
"18",18,5,80,78,90,248
"19",19,5,89,68,87,244
"20",20,5,78,83,58,219
